推荐3种好的诊股方法	推荐销售预测的3个方法?	0
如何用大盘择时	大盘指数	0
小市值股票投资策略是怎么样的	小盘股投资策略的优缺点是什么？	1
可转债如何实现转股	可转债怎样转股？	1
期货交割仓库的作用	期货交割仓库由谁指定？期货交割仓库是什么？	1
为什么要关注龙虎榜	为什么主力不想上龙虎榜	0
套涨期权的特点	套涨期权	1
指数投资主要跟踪哪几大指数	指数投资	1
大宗交易对股票的影响	大宗交易对股票的影响	1
理财型保险怎么挑	理财型保险收益怎么计算	0
银行发行的可转债会破发吗	银行转债会破发吗	1
连续缩量跌停是什么	什么是股票缩量跌停？	1
ADR的发行是否需要公司与SEC的批准	美国的企业债发行审核机构是 SEC 吗？为什么中国企业债的发行审核机构是国家发改委，而非证监会？	0
什么是ADR托管收费	基金托管费	0
如何制定有效的投资计划	如何制定股票投资计划？	1
可转债转股还是卖出好	可转债转股好还是卖出好？	1
总股本和流通股本的定义	流通股本和总股本什么意思	1
套跌期权怎么操作	套跌期权	1
太平保险和太平洋保险的区别	太平保险和太平洋保险区别？	1
风险逆转的内容	风险逆转的内容	1
什么是投资的风险和回报？	投资回报率与风险成比例是什么?	0
利率期货的影响因素	利率期货	1
投保人过世，怎么变更投保人	投保人死亡后怎样变更投保人	1
结算担保金与结算准备金的不同	结算担保金与结算准备金的不同	1
怎么选择好的交易策略	交易策略选择股票-经管之家官网！	0
做空的美股退市了怎么办	美股做空的股票退市了怎么办	1
什么可转债是顶格申购	可转债顶格申购什么意思	1
注册制新规对散户的影响	A股退市新规出炉，注册制后新股加速，散户盈利越来越难了！	0
一手可转债是几张？	一手可转债是多少张	1
什么是跑赢通货膨胀	什么是跑赢通货膨胀	1
股票投资中如何控制情绪	股票投资技巧？	0
港股的市价订单如何下单	市价订单	0
封单金额骤减有什么影响	涨停的股票封单金额只有几百万意味着什么	0
有哪些股票仓位管理策略	如何控制股票仓位	1
金融期货交易与金融现货交易的区别	金融期货交易与金融现货交易的区别	1
机构获利离场产生的影响	机构短买离场指标	0
港股风险大于A股吗？如何买卖	深度了解港股市场，风险远远大于A股	1
委托买入和委托卖出的撤单规则和操作方式	股票委托买入和撤单？	0
港股打新怎么打	港股打新怎么打	1
退市的规则是什么	创业板退市规则是什么	0
货币基金投资建议	货币市场基金投资对象有哪些	0
上市后可转债的涨跌幅限制	可转债上市首日涨跌幅限制？	1
期权的分类	期权的分类	1
股票和可转债哪个风险大？	可转债和股票哪个风险大？	1
结算准备金和结算担保金区别是什么	结算准备金和结算担保金有什么区别	1
DEA和DIF线的功用	dea线和dif怎么区别	1
基金累计净值高有什么影响	基金累计净值有什么用	1
如何建立和保持投资纪律？	怎样保持交易中的纪律？	0
怎么构建自己的交易体系	怎么构建自己的交易体系？	1
转让限售股解禁的相关规则	限售股解禁前如何转让	1
什么是盒式套利	盒式套利	1
期货交易时间	期货交易时间	1
套利性交易的内容及原理	套利性交易的内容及原理	1
如何研究公司的业务模式	怎样研究一个行业，企业的商业模式，和盈利模式?	0
可转债新规有什么影响吗	可转债涨跌受什么影响	0
全面注册制的利弊是什么	全面实行注册制利好什么	0
美股选股方法有哪些	美股的选股方法	1
新手可以炒港股么	新手炒港股好还是A股好？	0
如何购买美股	怎么购买美股	1
港股投资者如何分析公司财务报表	港股财报1：如何看懂一份港股财报（入门篇）	1
买可转债为什么每天都在亏本呢？	可转债为什么会亏本？	1
什么是光刻机	光刻机	1
如何应对投资的损失？	投资损失	0
下修对可转债的影响	下修对可转债的影响	1
怎么更好得在股市获利，可以推荐什么书籍给我	关于股票的书籍。 有人推荐三本书《周期理论》、《波浪理论》、《笑傲股市》，那一本更好？学习炒股一定要读书吗？谢谢!	0
我应该如何监控和诊断我投资的股票？	我现在想进行股票投资.应该怎么做?	0
绝对估值法为什么有用	绝对估值法的局限性	0
可转债退市会怎么样	可转债退市会怎么样？	1
有哪些龙虎榜选股策略	龙虎榜选股技巧？	1
股票为什么会退市	股票会不会突然退市？	1
如何能够成为在股市里赚钱的人	股市里能够赚大钱的只有两种人，一种是“疯子”，一种是“傻子”	0
分拆上市对母公司的影响	分拆上市对母公司的影响	1
什么是盘前和盘后交易	什么是盘前交易和盘后交易	1
有哪些分析板块的方法	如何分析板块	1
MACD死叉加仓会怎么样	macd死叉一定跌吗？	1
可转债上市首日卖了能赚钱吗	可转债上市首日可以卖出吗?可转债上市交易规则	1
ETF类基金买场内还是场外	场内、场外基金、LOF与ETF基金一文搞懂	1
什么是股价异动	股价异动	1
科创板新股交易规则	科创板新股股票交易规则？	1
国内期货市场有什么风险	国内期货市场现状？以及它在经济发展中的地位？	1
港股的投资方法和A股一样吗	港股与A股投资哪个比较好	1
配股和定增有什么关系	定增和公开配股有什么区别	1
退休人员，如何做投资	退休人员能做担保人？ 退休人员能做担保人吗	0
什么是恒生指数	恒生指数	1
股指期货的影响因素	影响股指期货价格的主要因素	1
美股限价盘什么意思	限价盘是什么意思	1
为什么发行可转债会利好	发行可转债是利好吗？	1
顶分型和底分型图形	顶分型和底分型包含关系吗	1
什么是技术分析和基本面分析	技术分析和基本面分析各是是什么意思	1
卖出开仓是什么意思	卖出开仓	1
港股受什么影响	港股市场会受哪些因素影响？可从哪些方面来分析？	1
股票停牌之后有什么影响	股票停牌了怎么办？之后该如何操作？	1
如何应对通货膨胀和汇率波动	通货膨胀是怎样影响汇率波动的	0
夏普比率过高对基金有什么影响	基金的夏普比率到底意味着什么？	1
可转债对正股股价的影响	可转债会影响正股股票吗？	1
什么叫关灯吃面	关灯吃面	1
H股就是港股吗？	h股是港股的基金吗	1
港股暗盘是什么意思？	港股暗盘是什么意思	1
美股市场包括哪些交易所	美股交易市场有哪些？	1
为什么分红要收税	基金分红收税吗？	0
新手可以买可转债吗	可转债怎么买,新手不会？	1
二元期权的优势	二元期权的优势	1
如何选择适合自己的基金品种	如何选择适合自己的基金品种	1
如何给父母买保险	如何给父母买商业养老保险	1
如何看待股票回购对股票价值的影响？	股票回购对股价的影响 股票回购会对股价的影响	1
基本保额是什么意思	基本保额	1
二元期权的特征	二元期权的特征	1
私募证券投资基金的特征	私募证券投资基金的特征	1
港股的H股和红筹股有什么不同	红筹股和H股有什么区别吗？	1
基金投资中的心理陷阱有哪些	基金投资：追涨杀跌的心理分析	1
投资能力包括哪些方面	投资能力	0
养老保险怎么买	买商业养老保险，怎么买？	1
大基金减持是利好还是利空	大基金减持是利好还是利空	1
早晨之星实战应用	早晨之星的市场含义及实战应用	1
大额医疗补助是什么意思	大额医疗费用补助	1
百万医疗险怎么挑	疫情对抗必选百万医疗险	0
美股适合做短线操作吗	什么样的股票最适合做短线操作？	1
如何看美股的季报发布时间	上市公司的年报、季报各是什么时候发布呢？如何查询呢？	0
美股和A股什么区别	美股与a股有什么区别？	1
港股市场的ESG投资理念是什么	战“疫”之下的港股投资及ESG投资策略	1
什么是复合期权	复合期权	1
怎样投资可以没有风险的每年挣15%	做中间商才真是无风险，投资少，一个人干，几年就挣了两套房子。	0
可转债为什么不火了	可转债为什么买不了？	0
如何平衡短期和长期投资目标，根据个人情况和需求调整投资计划	你的健康状况全在手上	0
基金的净值如何计算	基金净值是怎样计算出来的	1
期货标准化合约的定义	标准化期货合约	1
印花税双向收取吗	印花税是双向收取吗？	1
可转债怎么分析	可转债怎么看盘	1
期货白盘合约的特点	期货夜盘交易和白盘交易有哪些区别	1
如何评估基金经理的表现	如何评价基金经理及基金的选择	1
超大单净量是如何计算的	大单净量是怎么计算的	1
美股和A股的交易规则和交易时间差别在哪里	美股和A股交易时间相同么？	1
为什么有的股票有st的标志	有的股票前面的ST标志是表示什么	1
龙虎榜选股方法	龙虎榜短线选股方法怎么看	1
买港股需要什么条件	买港股需要什么条件	1
怎么样才算跑赢通胀	怎么样才算跑赢通胀	1
增发的股票多久解禁	股票增发多久可以解禁	1
ADR的红利和股息如何处理	股息红利税差异化处理是什么意思	0
什么是GDR	全球存托凭证	1
买房如何提取个人住房公积金	个人住房公积金如何提取	1
为什么美股里有些股票，是中文名	为什么美股中有些股票限空美国股市的“做空”某只股票是什么意思？	0
基金定投的原理是什么	基金定投微笑曲线原理是什么	0
如何评估一只股票的价值？	怎么正确评估和确定一只股票的真实价值?	1
我有两千美元，适合投资美股吗	美股适合散户吗？我有两千美元，适合投资美股吗？	1
取得高收益的影响要素	取得高收益的影响要素	1
如何评估基金经理的能力	基金经理实力如何评估，从哪些方面分析？	1
基金有什么优点	基金有什么优点	1
什么是黑天鹅事件	黑天鹅事件	1
正股退市可转债怎么办	可转债正股退市了怎么办？	1
如何评估基金公司的实力	基金公司投研实力哪家强	0
风险逆转怎么操作	风险逆转期权组合如何操作？	1
投资体系是什么意思	什么是投资宏观调控体系	0
你好，港股减持规则是什么样的	等你来回答更多	0
大学生有没有医保	大学生医保	1
什么是公开市场操作，它是如何影响股票价格的？	什么是公开市场操作？	0
什么是量化投资策略	量化投资策略	1
可转债的负溢价是怎么产生的	为什么可转债会出现负溢价？	1
紧缩性财政政策的特点	中国的紧缩性财政政策	1
美股的熔断规则	美股熔断规则？	1
股票投资中的市场分析有哪些方法	股票投资分析的基本方法有哪些	1
保险单上的免赔额是什么意思	保险单的现金价值是什么意思	0
为什么不直接发股票而发可转债	直接融资正当时，可转债、私募股票你该pick谁？	1
为什么价值投资也有风险	价值投资3	1
市价指令与限价指令的区别	市价指令与限价指令的区别	1
什么是标普500指数	标普500指数	1
为什么有人总是选择跟随热门投资方向进行投资	为什么跟着机构/投资人投资一定会亏钱	0
夏普比率反应了什么	夏普比率说明什么	1
ST股和其他风险警示股票的相关规则	上交所ST股票交易规则 相关规则一览	1
港股-R是什么意思	港股和科创A股的命名后字母（W,U,V,R,S,B)表示什么意思？	1
如何选择适合自己的基金	如何挑选自己适合的基金？	1
用什么方法今年可以跑赢银行利率5个点	利率上浮5个点怎么算	0
什么样的股票算白马股	什么股票是白马股票	1
有哪些交易策略	股票交易策略包括哪些类型	1
结算会员制度的引进原因	结算会员制度的引进原因	1
基金公司的信誉度对基金投资有何影响	股票基金投资第3坑-上市公司与基金公司之间的利益输送	0
什么是股指期货	股指期货	1
如何通过基金渠道投资港股	跟踪港股的基金,国内港股投资渠道有哪些	1
套期保值者的特点	套期保值者的套期保值者具有的特点	1
A股投资方法可以用于美股吗	普通投资者如何参与美股？有A股证券账户就行	0
不同类型基金的投资策略有哪些	基金理财妙招系列--指数基金	0
什么样的形态叫上吊线	上吊线的形态特征	1
上市公司发行可转债有什么要求	发行可转债对上市公司总资产净资产有何要求？	1
黄金分割线怎么找	商品期货 黄金分割线特殊位置怎么找	1
什么是金融期货合约期权	金融期货合约期权	1
为什么同一只股票在港股和A股价格不同？	同一支股票在a股和港股有什么不同	1
挣到100万可以不工作吗	挣到100万可以不工作吗	1
可转债票面金额怎么样算	可转债转股时可转债票面总金额是按面值算还是按市值计算？	1
如何进行风险控制与资产配置，以达到理想的收益	中国股市28年来发生的4次股灾 从中我们能够学习到什么？	0
三金叉选股战法介绍	三线金叉选股战法如何快速捕捉黑马股？	1
港股风险大于A股吗	港股风险大还是a股风险大	1
如何选择美股？	怎样购买美股	0
可转债适合定投吗	可转债适合定投么？	1
为什么要买保险	为什么要买保险？	1
有高血压，能买哪些保险	高血压	0
为什么要卖出看涨期权	为什么要卖出看涨期权	1
新手有哪些理财方式	新手投资理财方法有哪些	1
基金的多因子投资策略有哪些	汇添富成长多因子量化策略股票型证券投资基金	0
股票期货与股指期货的区别	股指期货交易与股票交易的区别	0
个人投资者要怎么购买港股通股票	个人投资者如何购买港股通股票？ 个人投资者如何购买港股通股票？	1
怎么通过筹码集中度判断主力意图	筹码集中度怎么看主力	1
基金分红期间为什么基金总市值和浮动盈亏会有变化	基金分红期间为什么基金总市值和浮动盈亏会有变化？	1
逐日盯市制度的组成	逐日盯市制度的组成	1
如何避免赌徒式投资习惯	不做盲从的赌徒:白银投资中怎样做止损与止盈?	0
投资目标有什么用	投资目标有哪些	0
机构持股过高，会导致股价下跌吗	为什么机构持股比例较高，股价却连续下跌？	1
政策风险的影响	政策风险的影响	1
解除限售的影响	解除限售的影响	1
影响期权价格的因素有哪些	影响期权价格的因素有哪些？	1
可转债套利双低怎么做	可转债常见的双低转债轮动套利模式	1
什么是打包期权	打包期权	1
如何制定基金投资的资金管理计划	基金投资是怎样管理？	0
什么是美国存托银行	美国存托凭证	1
医疗险哪些类型	医疗险观望期	1
期货与现货区别在哪里	期货与现货的区别	1
如何使用新闻和事件来预测市场走势	新闻事件	0
如何平衡基金投资的风险和收益	平衡型投资基金	0
什么是股指期货跨期套利	股指期货如何实现跨期套利?	1
如何识别和避免投资欺诈	投资型保险应避免的误区	0
怎样分析主力筹码	主力筹码情况分析	1
大笔买入和大笔卖出是什么意思	大笔买入是什么意思	1
熊市看跌期权套利怎么操作	熊市看跌期权套利的应用策略	1
如何避免情绪化决策和投资误区，保持冷静和理性	如何避免投资理财的十大误区	0
波动率的计算公式	波动率计算公式	1
解禁对股票有啥影响	股权解禁对股票的影响	1
如何投资地产股	地产股的投资建议	1
资本期货有哪些	资本期货	1
不敢买高位股票是什么原因	股票为什么低不敢买高了反而敢买？	0
对于新手，你建议从哪些方面开始进行选股？	对于股市新手有什么建议	0
买进看涨期权的实用策略	买进看涨期权的实用策略	1
要不要选择意外险	机票要不要买意外险	0
限仓制度的几种形式	限仓制度的几种形式	1
技术面分析大盘的方法有哪些	股票怎样进行技术面分析	1
什么是美股	美股	1
窝轮到期后的结算方式	窝轮到期结算方式是什么？	1
期货公司和私募基金的关系	期货公司参与设立私募基金	1
会员制和公司制期货交易所的区别	中国有哪几个期货交易所，分别是会员制还是公司制？	1
异价跨式组合怎么操作	异价跨式组合的运用	1
港股的交易费用包括哪些	港股交易费用有哪些 港股交易费用怎么算	1
闲置资金怎么投资理财	闲置资金怎么投资理财	1
什么是ADR	ADR	0
港股退市规则	关于港股退市的一些规则？	1
基金投资中如何控制情绪	基金投资	0
期货保证金存管银行的作用	期货保证金存管银行	1
期货能做空吗	期货能不能只做多不做空？有什么好处？	1
场内经纪人的类型	场内经纪人的类型	1
为什么要推行全面注册制	注册制全面实行利好谁	1
增发股票，对上市公司市值有何影响？	定向增发对上市公司市值及市值管理影响的实证研究	0
期货夜盘合约的优势	期货夜盘的好处	1
熊市和牛市，你的投资策略有何不同？	熊市与牛市初期的投资策略	0
基本医疗保险和城乡居民医疗保险的区别	城乡居民基本医疗保险	1
配售的可转债怎么买	配售可转债怎么买	1
股票价格与成交量的关系是什么	股市中成交量和股票价格有什么关系？	1
A股和港股交易有什么区别	a股和港股有什么区别	1
散户如何防范股市骗局	散户如何防范股市骗局	1
股指期货期权的功能与作用	股指期货与股指期权的关系	1
美股分红除权吗	美股分红除权吗	1
市场情况对基金的投资策略影响如何	有效市场理论如何影响投资策略 日期：2020-04-20 15:32:48 来源：互联网	1
熊市认购价差策略有什么风险	什么是熊市认购价差策略	0
基金十大持仓股的行业分布有什么影响	公募基金持仓行业分析	1
如何确定基金的业绩水平	基金业绩是什么？怎样查看。	1
熊市套利的特点	在正向市场中熊市套利最突出的特点	0
什么是利率上限期权	什么是利率上限期权？ 什么是利率上限期权？	1
股票退市了，可转债会跟着退市吗？	股票退市了可转债怎么办	1
出现射击之星是否要跑？	但凡出现“射击之星”形态，毫不犹豫逃，这是要割韭菜的节奏	1
什么是T+0	T+0	1
有哪些分析大盘的方法	沪深股市大盘走势分析方法（实战)	1
奶牛型现金流是什么意思	“奶牛型”现金流企业画像：分众传媒、贵州茅台及腾讯控股	1
如何买港股	怎么买港股	1
长期持有港股会怎么样	港股基金适合长期持有吗？	0
风险逆转的优点	风险逆转	1
期权清算公司的作用	期权清算公司的作用	1
基金频繁操作有什么影响	基金买卖频繁有什么影响？	1
基金的投资组合中包含哪些资产	投资组合中需要包括核心基金吗？	0
港股交易风险有哪些	请问港股交易风险大吗？怎么可以降低风险？	1
领口策略怎么操作	领口策略的交易过程	1
如何提升选股能力	怎样提高选股成功率	1
什么叫保险的宽限期	保险宽限期	1
投资组合中的资产分配和定期再平衡的重要性是什么	关于投资组合的再平衡	1
该如何选择指数来投资	该如何选择指数来投资	1
基金的历史业绩如何评价	基金的历史业绩是什么意思	1
可转债换手率高代表什么	可转债换手率高说明什么问题	1
美股中长线抄底战法	股指期货散户全攻略	0
套利性交易怎么操作	套利性交易	1
你如何评估公司的管理团队？	如何了解上市公司的管理团队优秀不优秀？	1
投资黄金为什么能避险	投资黄金为什么能避险	1
如何选择指数来投资基金	初学者如何投资基金	0
如何确定买入和卖出的时机？	如何判断股票的买入和卖出时机	1
做期货与做股票的区别有哪些	做期货和做股票的区别	1
什么是期权清算公司	期权清算公司	1
什么是港股a股溢价率	港股a股溢价率是什么意思	1
债券期权交易怎么操作	债券期权交易	1
期货合约的作用	期货合约的作用	1
人民币外汇期权交易怎么操作	工行代客人民币外汇期权交易怎么操作？ 工行代客人民币外汇期权交易怎么操作？	0
强制储蓄和投资理财有什么关系	强制储蓄和投资理财有什么关系	1
美股的股票在国内怎么买	在国内如何购买美股？	1
ETF基金应该怎么买	ETF基金怎么买?	1
什么是养老金	退休金	1
什么是期权市场	期权市场	1
特定国家或地区投资策略有哪些	融资融券	0
套跌期权的特点	套跌期权	1
规避强行平仓风险的建议	规避强行平仓风险的建议	1
股票出现双顶形态好不好	股票k线出现双顶图形意味着什么	1
可转债回售是利好还是利空	可转债回售是利好还是利空	1
可转债为啥会停牌？	可转债为什么会停牌？	1
期货结算制度的特点	期货结算制度	1
实物交割制度的功能与作用	实物交割制度的重要性	1
强行平仓制度的功能与作用	强行平仓制度	1
可转债明明被套为啥说能保本	说好的可转债保本，为什么也亏钱了？	1
基本面分析在投资美股中的作用是什么	基本面分析是分析什么	1
大单和小单是怎么区分的	股票中大单小单是怎么区分的	1
什么是利率期货合约	利率期货合约	1
港股为什么不能无脑打新	港股打新=无脑捡钱？	1
适合超短线的选股方法有哪些	超短线的选股方法	1
期货连续合约是什么意思	期货连续合约是什么意思	1
为什么说有大量密集的蓝色筹码，这种股票不要碰?	一支股票的筹码分布图，全是蓝色的筹码，几乎没有或者只有很少的红色筹码，说明了什么，会说明股价会反弹	1
期货合约与远期合约的区别	期货合约与远期合约的区别	1
如何读懂公司的财务报告？	如何通过财务报告看懂一家企业	1
什么是套期保值者	套期保值者	1
可转债临时停牌规定	可转债盘中临时停牌规则	1
违规担保有什么危害	违规担保有什么危害	1
什么是会员制期货交易所	会员制期货交易所的最高权力机构是？	1
什么是期货转现货	期货转现货	1
现货期权与期货期权的差异	现货期权与期货期权的差异	1
期权与期货的关系	期权和期货具体是什么关系？	1
美股能做空吗	谁在做空美国股市？	1
为什么要设定投资目标	为什么要设定投资目标	1
可转债不能用双突战法吗	你的健康状况全在手上	0
停牌的原因有哪些	停牌的公司有哪些及原因	1
封闭式基金折价原因	封闭式基金折价原因	1
美股手续费是多少	美股手续费是多少?	1
东数西算是什么意思	东数西算是什么意思	1
横盘如何判定	什么是股票横盘？怎样确定横盘后的走势？	1
买进双向期权怎么操作	买进双向期权	1
美股停盘规则	美股停盘是啥意思	1
什么是买入套利	买入套利	1
为什么美股适合长期投资	艾德一站通：美股适合长线投资吗？哪些股票值得长期拥有？	1
市调价格是什么意思	在中原地产的市调上面看见一个叫CLI二手住宅（租金）价格指数。请高手给我详细解释一下这个图如何看。	0
风险逆转的功能与作用	风险逆转	1
买可转债规则是啥	可转债的交易规则？	1
准备拉升的股票具备哪些特征？	股票拉升的股票有什么特征？	1
主板实施注册制以后有什么不同	创业板实施注册制后对主板的影响	0
美股t+0规则	美股T+0及日内交易者(Pattern Day Trader)规则介绍	1
美股熔断和A股熔断的区别	瑞幸盘中为何熔断多次 美股大盘个股熔断有何区别	0
股民的投资目标有哪些	你的健康状况全在手上	0
投机头寸限仓制度的特点	投机头寸限仓制度	1
牛市认沽价差策略有什么风险	牛市认沽价差策略	1
港股衍生品博弈的本质是什么	等你来回答更多	0
什么是医疗保险	医疗保险	1
投资美股需要掌握哪些市场交易规则和机制	如何投资美股？美股有哪些交易规则？	1
可转债能做T吗？	可转债做T技巧？	1
港股后面带个s是什么意思	港股后面带SW啥意思	1
除权除息当天买有什么影响	除权除息日前几天购买股票能分红吗当日购买能...	1
跨式套利的类型	跨式套利的类型	1
什么是美股盘前交易	什么是美股盘前交易	1
混合期权的分类	混合期权的分类	1
股票期权的特征	股票期权的特征	1
影响期货涨跌的因素有哪些	期货价格涨跌的影响因素有哪些	1
美股净资产高好还是低好	什么叫美股净资产	1
什么是纽约证券交易所	纽约证券交易所	1
股票出现ST会有什么影响	股票变st是什么意思？股票变st会有什么影响？	1
窝轮权证的操作技巧	窝轮	1
定投指数基金不学会止盈有什么影响	定投指数基金怎么止盈？	0
保险应该怎么选	保险应该怎么选？	1
为什么公司发布利好消息股价往往下跌	到底为什么天天发利好消息股价却天天下跌，公司	1
你如何看待特定事件（如新产品发布、并购事件等）对股票价格的影响？	纽约证券交易所	0
美股可转债有哪些种类	美股有可转债吗？	1
集合竞价的参与要求和规则	有关集合竞价的规则?	1
经济萧条期的影响因素	经济大萧条的影响	0
基金净值和基金份额的关系是什么	基金份额和基金净值分别是什么意思？？？	1
大阳包三阴是怎么样的	大阳包三阴	1
投资心态对成功投资的影响	成功投资者有哪些心态值得我们学习?	0
套涨期权怎么操作	套涨期权	1
失业保险领取的条件	社保的失业保险领取的条件？	1
股票的交易规则	股票交易规则	1
分红送转是什么	分红送转	1
业绩增长，但股价跌的原因	公司的业绩再增长但是股价却在下跌为什么	1
期货合约到期怎么处理	期货合约到期怎么办	1
熊市看跌期权套利的应用策略	熊市看跌期权套利的应用策略	1
A股的选股方法可以用于港股吗	我的选股方法：1,打开沪深A股，点DDE决策。再点飘红天数的10日。右键批量操作	0
如何绝对不亏钱投资	现在买房买在哪里都涨得不快，但只要学会这一招，就不会不亏钱！	0
金融期权与金融期货的区别	金融期权与金融期货的区别	1
风险控制能力弱有什么影响	企业风险控制能力	0
熊市看涨期权套利的特点	熊市看涨期权套利	1
基金定投和购买有什么区别	基金定投和购买什么区别	1
垂直套利怎么操作	垂直套利	1
保证金制度的作用	保证金制度的作用是什么？ 保证金制度的作用是什么？	1
买入看跌期权的功能与作用	买入看跌期权	1
可转债怎么操作才能赚钱	可转债怎么买赚钱	1
新手适合炒美股么	基金和股票哪个适合新手	0
为什么有的股票没有沪深港通	为什么有些股票不支持沪深港通交易	1
ETF投资方法	ETF基金投资方法	1
XD可转债是什么意思	xd可转债是什么意思	1
为什么消费类股票要用市盈率估值呢	市盈率估值	0
对于初学者来说，了解基础知识和技能的重要性是什么	从零开始学习炒股票 对于初学者怎么入门？	0
ADR有多种级别，分别是什么	你的健康状况全在手上	0
一般可转债多长时间上市	可转债发行后一般多久可以上市	1
旅游要买什么保险	境外旅游需要买什么保险？	1
投资者买卖港股通股票能否卖空	投资者买卖港股通股票能卖空吗	1
为什么市盈率亏损，股价还会上涨	市盈亏损为什么股票上涨？	1
如何抓小盘妖可转债	中国股市28年来发生的4次股灾 从中我们能够学习到什么？	0
买基金越便宜越好吗	基金是不是买的人越多越便宜	0
蚂蚁保险是正规保险吗	蚂蚁保保险代理有限公司	1
人民币外汇期权交易的功能与作用	人民币外汇期权交易的币种有几种	1
可转债怎么薅羊毛	可转债打新薅羊毛	1
各种理财方式的区别	各种理财方式的特点	1
基金的止盈止损策略有哪些	有什么好的止盈策略？	1
基金的交易方式有哪些	场外基金的交易方式有哪些	0
如何避开老千股	如何避开老千股	1
中小板上市条件	中小板上市条件	1
港股大单中单小单怎么区分	股票大单中单小单是什么意思	1
公开增发对原有股东利益的影响	公开增发对原有股东利益的影响	1
什么是期货保证金	期货保证金	1
交强险怎么买	只买了交强险把人碰了怎么赔	0
并购重组一般停牌几天	并购重组停牌时间有多长	1
为什么先公司后行业	工程行业先开票后收款会计分录怎么写	0
如何进行基金投资的行业分析	如何运用行业指数基金投资	0
港股溢价怎么看	港股溢价什么意思	0
有100万应该怎么做成功的投资	100万可以做什么投资	0
什么是深度实值期权	什么是深度实值期权	1
庄家为什么要洗盘	庄家为什么要洗盘？	1
怎么选择基金费用来降低投资成本	基金成本是什么意思	0
推荐我三个选股的课程	谁能给推荐一般选股策略方面的书？	0
如果理解和比较保险里的条款	怎样理解李嘉图的比较优势理论	0
期权交易有哪些风险	期权交易有哪些风险	1
美股怎么止损	美股的止损单什么意思	1
美股分红和A股一样吗？有哪些区别？	美股的分红制度跟A股一样吗？	1
*st和st有什么区别	*st和st有啥区别	1
如何构建基金组合	怎样构建自己的指数基金组合？	1
怎么选择适合自己的重疾险	如何选择一份适合自己的重疾险？	1
什么是股票期权，我应该如何使用它们？	股票期权怎么做？	1
期权内涵价值的计算公式	期权内涵价值公式，期权内涵价值计算 日期：2018-05-25 15:03:18 来源：互联网	1
什么是H股和红筹股	什么是红筹股？红筹股和H股的区别	1
可转债回售套利	可转债回售套利	1
可转债怎么样才不亏	请问可转债如何做到只赚不亏?	1
现金流量表该怎么看	怎样看懂现金流量表	1
购买医疗保险怎么买	成年人该怎么购买商业医疗保险	1
庄家吸筹怎么办	庄家吸筹方式	0
近3年年化超额收益率为负是什么意思	宏观经济学习题_3	0
如何看待价值投资和成长投资的区别？	价值投资和成长投资的区别	1
美股做空是什么意思	美股做空是什么意思	1
基金经理的背景和能力如何评估	基金经理实力如何评估，从哪些方面分析？	1
借壳上市和重组，有什么区别？	借壳上市与资产重组区别	1
领口策略有什么风险	期权策略说：牛市看涨价差策略的介绍和运用	0
投资美股应该如何入门	投资美股应该如何入门？	1
怎么找到新行业的龙头股	怎么找行业龙头股	1
股票交易费用的计算和收取标准	股票交易费用怎么收取	1
港股汇率怎么算	港股通汇率怎么算	1
港股涨跌影响a股吗？	港股上涨会影响a股吗	0
10日均线是什么意思啊	10日均线	1
如何看上市公司的定向增发	上市公司如何定向增发	0
债券型基金是什么意思	债券型基金	1
净利润大增为什么股价还会跌	为什么净利润一涨股价也跟着涨	0
什么是过度自信和市场追逐，我如何避免这些陷阱？	关于联合授信对解决过度授信作用的思考！	0
当日无负债结算制度的优点	当日无负债结算制度	1
早盘选可转债技巧	一种转债早盘获利技巧	1
什么是期货居间人	期货居间人	1
股价上穿200日均线是否意味着可以加仓	股价上穿30日均线意味着什么？	0
投机头寸限仓制度的交易细则	投机头寸限仓制度的交易细则	1
如何对不同的投资品种进行风险分析	投资项目风险分析	0
期货结算机构的作用	期货结算机构的作用	1
炒股为什么总亏钱	炒股为什么总亏钱	1
不同基金的投资方法	不同基金的投资方法	1
指数基金最好持续投资多久	指数基金适合投资吗	1
公司提供担保是利空吗	为子公司提供担保是利好还是利空	0
可转债上市破发怎么办	可转债破发怎么处理？	1
注册制的优势	注册制的作用	1
系统性风险和非系统性风险的区别	系统性风险和非系统性风险的区别	1
如何评估一只基金的价值	怎么判断一只基金的投资价值	1
强制减仓制度是什么意思	强制减仓制度	1
美股普通市价和限价单区别	详解美股中的几种交易单-限价单、市价单、止损单、止损限价单、跟踪止损单	1
怎么选择商业保险	商业保险主要有哪些种类？应该如何选择适合自己的保险？	1
国内期货市场的特点	国内期货市场现状？以及它在经济发展中的地位？	1
市场风险和利率风险的关系	市场风险和利率风险的关系	1
什么是港股的国企股票	港股如何分类：什么是红筹股？什么是国企股	1
商品期权交易怎么操作	商品期权交易	1
如何选择适合自己的基金投资方式	如何挑选自己适合的基金？	0
女生要买什么保险	高考刺死同班女生 给学生买保险有哪些技巧?	0
为什么说炒股就是炒心态	炒股就是炒心态	0
怎么选择适合自己的医疗险	选择最适合你的保险	0
阶段底部买入有什么影响	阶段性底部已经到来！	0
什么是期货佣金商	期货佣金商	1
港股市场的T+2结算规则是什么	港股通资金流向统计(T+2)：美团点评-W南向资金净流入金额位列市场第一	0
修正可转债对股价有影响吗	下修可转债对股价影响	1
美股为什么有盘前交易	什么是美股盘前交易	1
场内基金和场外基金有什么区别	场内基金和场外基金的区别	1
沪深港股通是什么意思	港股通沪深的区别是什么	1
老牌牛基优选策略	老牌牛基系列--华夏大盘精选混合	1
期货交易所有哪些	期货交易所有哪些？	1
公募基金自购的主要原因有哪些	怎么看公募基金掀起的自购潮？	1
理财型保险有哪些	理财型保险有什么	1
0BV是什么指标	obv	1
股指期货与股票的关系	股指期货与股票的关系	1
为什么美股分时走势图是梯形	关于美股交易员 我们做美股能不能直接看分时走势图然后进行交易？20	0
投资策略中，技术分析和基本面分析哪个更重要？	股票技术分析和基本面分析的区别	1
看涨期权的定价公式	看涨期权的定价公式	1
期货价格的涨跌是如何产生的	期货价格的涨跌是如何产生的？	1
可转债有多大的风险？	申购可转债有风险吗？	1
如何避免让情绪影响我的投资决策？	如何愉快地做出正确的投资决策？	1
可转债为啥没波动	可转债波动大吗	1
基金的波动性如何评估	白酒指数基金比债券指数基金波动性大吗？	0
熊市认购价差策略怎么操作	熊市认购价差策略	1
在什么情况下我应该进行资产配置调整	为什么要进行资产配置，它对我的投资有什么意义	0
投资美股的好处	美国股市k线图分析 是投资美股关键	0
如何选择适合的基金经理	怎么选择基金经理	1
追踪强势板块操作会怎么样	独立操作和判断，第一时间发现强势板块才安全	1
期货合约价值计算公式	期货合约价值公式	1
涨停的可转债怎么买	股票一涨停立刻就买可转债，能大赚吗？	1
什么是纳斯达克综合指数	纳斯达克综合指数	1
期货投资浮动盈亏的计算方法	期货投资盈亏比怎么算（期货盈亏怎么算的）	1
换手率和实际换手率有什么区别	换手率和实际换手率的区别	1
会员分级结算制度与全员分级结算制度有什么区别	会员分级结算制度	0
FAK指令的功能与作用	FAK指令	1
我应该如何选择投资的行业或板块？	如何才能有效地进行股票投资中的行业板块选择	1
港股交易规则	港股t+0交易规则？	1
什么是资产配置，为什么它很重要？	为什么要做资产配置？	1
主力控盘比例多少合适	主力控盘比例多少比较好	1
为什么股票100股起买	为什么股票要100股才能买?	1
中了可转债怎么操作？	中了可转债怎么操作？	1
可转债双低策略什么意思	可转债双低策略是什么意思	1
你如何建议我管理和调整我的仓位？	基金仓位管理怎么做 根据市场情况进行仓位调整	0
可转债负溢价什么意思	为什么可转债会出现负溢价？	1
盘口数据中的买卖五档是什么意思	五档盘口是什么意思	1
可转债交易难度大不大	可转债投资风险大不大？还可以投资吗？	1
基金净值起点高低有什么区别	基金净值起点高低有什么区别	1
跨式交易的分类	跨式交易的分类	1
怎么计算市盈率和市净率	市盈率和市净率怎么计算	1
期货期权的优点	期货期权的优点	1
抛补期权头寸有什么风险	抛补期权头寸	0
融资融券交易有哪些特有风险	融资融券交易有哪些特有风险？	1
什么是行为金融学，我应该如何应用它来改善我的投资决策？	行为金融学	0
为什么会产生通胀	为什么会产生通胀	1
港股红利派机制	港股红利派发与A股相比有什么差异	0
内幕交易有什么危害	内幕交易有什么危害	1
如何通过基本面分析评估公司的内部价值	企业价值评估和基本面分析	1
为什么这么多人用龙头选股战法	龙头股选股战法（附选股公式）	1
什么叫可转债的纯债价值	什么是可转债的纯债价值？ 什么是可转债的纯债价值？	1
红三兵形态的形成原因	红三兵的形态特征	1
小孩的意外险怎么挑	小孩子有必要买意外保险吗？	1
适合保守型用户的选股方法有哪些	保守投资，适合绝大多数投资者的选择	1
年轻人先买房还是先买车	年轻人先买房还是先买车	1
什么是市盈率ttm	市盈率ttm	1
管理费用的计算公式是什么	管理费用率的计算公式	1
如何区分深港通和沪港通股票	沪港通与深港通股票范围	1
科创板有什么重要意义	科创板有什么重要意义	1
什么是国际清算银行收据	国际清算银行	0
垂直套利的功能与作用	垂直套利	1
清算所的功能与作用	期货清算所的作用	1
看研报先看什么？	研报主要看什么内容	1
为什么要仓位管理	仓位管理	1
分析股票融资融券多少合适	股票融资占比多少最合适：融资融券比例，比如十万可融多少	1
为什么大家都说美股适合做价值投资	为什么绝大部分人都不适合做“价值投资”？	0
港股的清算和交收如何进行	港股如何进行结算和交收？	1
激励性股票期权的条件	激励性股票期权的条件	1
美股与美债的关系	美债与美股的关系	1
经济萧条期是指什么	经济萧条期是什么？ 经济萧条期是什么？	1
怎么才能买美股	怎么才能买a股	1
股票除息日对股价的影响	股票除息日对股价的影响	1
股票质押交易的规则和操作流程	股票质押式回购交易的业务流程	0
跨境ETF与QDII基金的区别	跨境ETF基金与QDII基金有何区别？	1
想要跑赢通胀的投资方法有哪些	资金想要跑赢通货膨胀要怎么做才好？	1
深交所分级基金母基金申购渠道是什么	6位数的基金代码，懂的都是老基民	0
股票增持的原因有哪些	股票增持的原因有哪些？	1
为什么股票价格会上涨或下跌	股票价格为何会上涨	1
购买回购股票策略的是什么	股份回购策略	1
美股和A股最主要的区别有哪些	美股和 A 股最主要的区别有哪些?	1
底部出现箱型震荡对后续走势有什么影响	股票在底部出现下跌，看一下成交量，若出现这样的走势就不用担心	1
如何进行基金投资的市场分析	面对市场分化行情，如何做好基金投资？	0
港股怎么套利	港股打新+A股套利	1
为什么要做价值投资	投资价值和价值投资	0
基金经理的能力对基金投资有何影响	基金分红对基金投资有影响么	0
合同负债高好还是低好	负债率高好还是低好	0
二元期权普及的原因	二元期权普及的原因	1
港股新股申购风险大吗？	港股打新是什么？怎么做？风险高吗？	1
如何简易判断大趋势	股票如何判断趋势改变	1
北向资金连续大幅流入怎么操作	A股盘中大幅下跌，北向资金结束净流入，后续该怎么操作？	0
怎么选择靠谱的保险公司	中国最靠谱的保险公司 这家最多消费者选择	1
如何分析竞争格局	市场竞争格局分析如何分析？	0
可转债新股民可以买吗	新开户可以买可转债吗？	1
如何使用短线交易策略获得高回报	外汇高手常用的短线交易策略	0
期货结算制度的分类	期货结算制度的分类	1
五险中的生育险怎么用	五险	0
如何选择适合我的券商或投资平台？	如何选择适合自己的交易周期	0
什么是可转债	可转债股票	1
有哪些买卖策略	股票买卖有哪几种策略？	1
基金的定投时间是否有讲究	基金定投有时间限制么	0
股票集合竞价为什么不能撤销	股票集合竞价期间为什么不能撤单	1
基金定投的优点有哪些	基金定投的优点有哪些？	1
政策因素对期货有哪些影响	政治、政策因素如何影响期货价格？	1
买入看涨期权的功能与作用	买入看涨期权是什么？	1
对于业绩不佳的股票，我应该如何应对？	利润和业绩对于股票的影响	1
港股的交易限制是什么	港股通交易有哪些限制？	1
怎么投资才能稳赚不赔	怎么投资才能稳赚不赔	1
什么是港股的IPO	港股IPO可以参与吗	1
如何区分真假横盘	如何分辨真假横盘？	1
量能是什么	量能	1
如何提升投资能力	如何提高自己的投资能力	1
如何使用资金流向指标辅助股票交易判断	资金流向	0
为什么要买进看跌期权	为什么要买进看跌期权	1
如何对基金进行分散化投资	信管家洞察丨分散化投资——专业机构如何打造公募基金的多资产多策略组合？	1
嵌入式期权的特点	嵌入式期权的特点	1
什么是异价跨式组合	异价跨式组合	1
披露财报的时间一般什么时候	如何查询上市公司年报披露时间？财报什么时候披露	1
如何选择长线牛股	如何选择长线牛股	1
你建议使用哪些交易策略？	期权交易有哪些使用的交易策略？	1
ADR和普通股之间有什么区别	ADR 和ADS是指什么？普通股与它们的兑换比例是怎么计算的？	1
公司新技术专利获批对股价有什么影响	上市公司股价对公司有什么影响	0
港股一手等于多少股	港股一手是多少股	1
港股沽空操作有哪些	港股中“沽空”是什么意思？如何操作？	1
什么是港股	港股	1
如何看待美股和A股的差别和内在逻辑	如何看待美股和A股的差别和内在逻辑？	1
可转债要注意什么	可转债是什么？投资可转债要注意什么？	1
如何分析基金的风险与收益	基金的风险收益特征，基金的收益风险分析	1
二元期权的原理	二元期权的原理	1
美股盘前的盘中有什么区别	美股盘前的盘中有什么区别	1
美股ETF有哪些种类	美股ETF有哪些种类	1
港股暗盘行情可以融资买入吗	港股新股暗盘行情速报	1
涨跌停板的设定和调整	涨跌停板	0
如何进行基金投资的基本面分析	基金投资的分析方法有三种基本分析技术分析和演化分析	0
美股发行价和首日开盘价的区别	发行价和首日开盘价的区别美股	1
投资心态的重要性	直击人性的弱点，论投资心态的重要性！	1
如何看待伞型结构基金	如何看待伞型结构基金	1
基金的价值投资策略有哪些	关注价值投资策略基金	1
什么是美式期权	美式期权	1
如何参与基金定向发行	参与上市公司定向增发的定增基金----是怎么个玩法？	1
止盈位怎么算的？	止盈止损位如何计算	1
如果紧急需要用钱，可以提前卖出基金吗	我的基金在封闭期内，但我需要用钱，怎么卖出啊？	0
macd金叉有什么影响	macd金叉有用吗	1
投资基金需要注意哪些风险	基金投资中还有哪些其他风险	1
如何在投资中保持耐心和长期视角	如何在股市中长期保持良好的投资心态	0
美股如何加杠杆	炒美股可以加杠杆吗？	1
ETF基金能套利的原因是什么	etf基金如何套利	1
如何防范期货市场上的风险	如何规避期货市场的风险？	1
公司员工增持计划对股价什么影响	员工持股计划好不好？影响买股吗？	1
央行加息有什么影响	央行加息的影响	1
怎么分析公司营收情况	企业营业情况分析,企业营业收入分析案例	1
可转债折价策略	可转债咋样看折价	1
股票市场是如何运作的？	股票市场是怎么运作的	1
多头宽跨式套利的缺点	多头宽跨式套利的缺点	1
基金估值有哪些陷阱	基金估值	0
监管机构的监管制度和处罚措施	证券监管机构的执法措施	1
持仓限额制度的具体规定	持仓限额制度的具体规定	1
年报净利润超预期可以怎么操作	关于年报里面净利润的问题	0
全面注册制是利好还是利空	注册制是利好还是利空	1
现在做可转债不挣钱了吗？	申购可转债真的能赚钱吗？	1
五保险包括哪些	保险的五要素是那五要素	0
如何选择合适的美股ETF	如何选择合适的美股ETF	1
什么是适合普通上班族的投资品种	普通上班族适合做什么样的投资？	1
股票分红影响股价吗	股票分红会影响股价吗	1
资金持续流出对股票有什么影响	资金净流入和净流出对股票影响	1
美股上市和国内上市的区别	美股上市和国内上市的区别	1
宏观经济因素对基金投资会产生什么影响	基金投资，2022年股市行情会如何	0
为什么要引进分级结算制度	为什么要引进分级结算制度？	1
倒三阳是好是坏	倒三阳	1
并购重组复牌是什么意思	并购重组复牌	1
可转债强制赎回涨的概率大吗	可转债被强制赎回正股会跌吗	0
美股开盘价如何确定	美股的开盘价如何确定	1
什么是场内期权	场内期权	1
美股交易规则时间	美股交易规则	1
重疾险要怎么挑	重大疾病保险	0
港股成交价如何定的	港股的成本价怎么算	1
介绍下波段交易策略	日内、波段、长线的外汇交易策略	1
保险都有哪些种类	保险都有哪些种类	1
什么是可转债溢价率	啥是可转债溢价率	1
港股的股票代码是如何构成的	港股股票代码是多少开头	1
什么是风险逆转	风险逆转	1
买入双向期权怎么操作	买入双向期权	1
可转债下修指什么	可转债下修是什么意思？	1
港股的限价订单如何下单	港股通是内地投资者委托内地证券公司，经由上交所证券交易服务公司（即上交所SPV），向联交所进行申报，在一定额度内买卖规定范围内的联交所上市的股票。	0
筹码集中度为什么越低越好	筹码集中度是越低越好吗？	1
单身要配置哪些保险	单身，如何用保险来保障自己的人生？	1
美联储加息主要有哪些原因	影响美联储加息的因素有哪些	1
ADR是否适合所有类型的投资者	下列属于存托凭证对投资者的优点的有（ ）。 ①以美元交易，且通过投资者熟悉的美国清算公司进行结算 ②上市交易的ADR须经SEC注册，有助于保障投资者权益 ③上市公司发放股利时，ADR投资者能及时获得，...	0
新手如何投资基金	新手如何投资基金	1
跨式交易的功能与作用	跨式交易	1
期权上市对期货有哪些影响	期权上市对期货有哪些影响	1
融资融券的规则和操作细节	融资融券的融券是怎么操作	0
什么是港股通沪港通和深港通	内地买卖港股是开通沪港通、深港通还是港股通？	0
或有索取估价法的特点	或有索取估价法的特点	1
窝轮敏感度的计算方式	窝轮敏感度的计算方式	1
保险定损流程是什么	汽车保险如何理赔？汽车定损理赔流程	1
定投有哪些优势	基金定投有哪些优势	1
港股什么时候披露年报	港股年报什么时间发布	1
风险逆转有什么风险	风险逆转	1
到期日效应产生的根本原因	到期日效应的根本原因	1
期货介绍经纪商的职能	期货经纪商的职能	1
隐含期权的影响	隐含期权的影响	1
什么是道琼工业平均指数	昔日全球巿值最高企业被道琼工业指数剔除	0
商品期权与股票期权的区别及优劣势	商品期权与股票期权的区别及优劣势	1
港股打新中签率高吗？	港股打新中签率高吗	1
美股卖出后，资金如何转回国内	美股卖出后，资金如何转回国内？	1
基金投资的风险有哪些	基金投资中还有哪些其他风险	1
股指期货交易与股指期权交易的区别	股指期货交易与股指期权交易的区别	1
如何根据股票财务报表分析确定股票是否被低估	怎样判断被低估的股票	0
美股大跌为何影响中国A股大盘	美国股市和中国A股的差别是什么？	0
基金有哪些类型	证券投资基金主要有哪几种类型 证券投资基金分为哪些类型	1
港股集合竞价规则	港股集合竞价规则有哪些	1
北上资金和深股通区别	沪深股通净流入和北上资金流出区别	0
基金的收益分配方式是什么	基金收益分配的方式有哪些?	1
为什么一家公司能在A股上市又在港股上市	一个公司如果在A股已经上市有100w的股本，然后这个公司又要在港股上市。请问在港股上市的资本从哪里来的？100	1
激励性股票期权与非法定股票期权的区别	激励性股票期权与非法定股票期权的区别	1
炒可转债比股票好炒吗	炒可转债比股票好炒吗？	1
期货保证金交易制度是什么	期货的保证金交易制度	1
什么是基金的资产规模	基金资产规模是什么意思	1
如何平衡股票投资的风险和收益	股票投资中如何平衡风险与收益的关系	1
美股平仓什么意思	美股中平仓是什么意思	1
开通港股通流程麻烦吗	港股通开通流程	1
什么是陆股通、港股通、沪股通、深股通	陆股通和港股通的区别？	0
什么是期权的熊市价差策略	什么是熊市认购价差策略	1
马鞍式策略怎么操作	马鞍式策略	1
什么是股权质押	股权质押	1
价升量缩是什么原因	价升量缩什么原因	1
新基金净值远高于1元的原因有哪些	新基金净值为什么不是1？	1
基金的费用包括哪些	基金费用包括哪些	1
为什么深市的可转债在每个计息年度之内只有一次向下修正股价的权利	为什么深市的可转债在每个计息年度之内只有一次向下修正股价的权利	1
如何了解行业趋势	为什么要了解所处行业发展趋势	0
不同类型的投资有哪些优缺点？比如，股票、基金、债券等。	投资基金与股票债券投资工具有何不同	0
基金经理变更有哪些原因	基金为什么会更换基金经理 哪些情况下基金经理会被换掉	1
期权时间价值的计算公式	期权时间价值计算公式	1
大股东增持为什么是利好	大股东增持为什么是利好	1
港股有没有涨跌幅限制	港股有涨跌幅限制吗	1
美股的开盘价如何确定	美股的开盘价如何确定	1
什么是10-K报告	如何读懂美国上市公司10-K年度财务报告	1
基金经理的作用是什么	基金经理的作用	1
免申购费是什么意思	免认购费，免申购费，免赎回费都有那些？	0
什么是龙头股、次新股、ST板块等股票分类	次新股锂电池龙头股是什么	0
可转债要怎么样找投资热点	股票对应的可转债怎么找	0
如何进行基金投资的技术分析	对某只股票的技术分析——牧童基金投资学堂（4）	0
跨式交易怎么操作	跨式交易	1
对于新手投资者，你有哪些建议？	巴菲特对投资者的建议	0
什么是场内基金和场外基金	什么是场内基金和场外基金	1
股票复牌有哪些规定	暂停上市股票复牌规定	0
小白怎样玩可转债才赚钱的	小白怎么快速做可转债打新？	0
可转债T＋0交易制度吗？	可转债为什么是t+0交易制度？	1
FOK指令的功能与作用	FAK指令与FOK指令的区别?	1
购买基金时为什么会按比例配售	购买基金时为什么会按比例配售	1
长线期货交易的优势和劣势是什么	做期货交易是短线好还是长线好？为什么？	0
如何判断底部放量突破	什么是底部放量突破的股	1
机构持股比例达到多少算好的	机构持股比例多少最好？	1
什么是强行平仓制度	强行平仓制度	1
小白可以买可转债吗	可转债小白常见问题答疑	1
如何选择适合自己的投资品种和策略	如何挑选自己适合的基金？	0
利率期货有哪些	利率期货的分类有哪些	1
美股暗盘交易方法	美股暗盘坐庄具体如何操作？	1
股票退市有什么影响	股票退市有什么影响?	1
为什么外盘大于内盘股价会下跌	外盘大于内盘股价下跌说明什么	1
沪港通规则	沪港通交易规则	1
如何理解和利用风险和回报的关系？	如何把握和利用风险与收益的平衡关系	1
买了五险还需要买农村合作医疗吗	买了商业保险还需要买农村合作医疗吗？	0
美股的三大股指有什么区别	美国股市三大指数 美国股市三大指数是指什么	1
小白如何购买可转债	可转债双低策略,小白也能学会	0
合约调整对备兑开仓的影响	合约调整对备兑开仓的影响	1
什么是正确的投资心态	投资者应有的正确心态	1
如何看待股息的重要性？	如何看待股息率的运用？	1
美股换手率计算方式	美股一般换手率是多少？	0
港股和美股哪个更值得投资	相比国内的股票和港股，美股是更好的投资手段吗？	1
陆股通资金和港股通资金的区别	港股通资金流向和沪股通资金流向有什么区别	0
炒港股的优势	炒港股实战指南	0
可转债选债策略	可转债如何实现高收益增长？双低策略选债了解一下	1
商品期货介绍	商品期货	1
上有老下有小的中年人要买什么保险	中年人大家觉得买保险应该怎么选？	1
基金投资的行情预测应该如何进行	市场行情预测	1
对角差价的特点	对角差价	1
可转债和股票的区别	可转债和股票的区别	1
普通人拿多少钱来炒股	普通人拿多少钱炒股合适	1
融资融券余额越来越少可能是哪些原因	融资融券余额越来越少说明什么原因	1
低位换手率高什么原因	低位换手率高是什么原因	1
港股投资的主要风险有哪些	参与港股投资的主要风险包括哪些？	1
假阴线上涨的几率有多大	岀现假阴线的股票下个交易曰上涨的机率大吗	1
港股跟A股有什么区别吗	a股和港股有什么区别？	1
注册制和核准制的区别	注册制和核准制的区别	1
基金投资应该遵循哪些原则和方法	养老基金投资须遵循的“四项基本原则”	0
注册制新股能当日买卖吗	创业板注册制可以当天买卖吗？	0
港股投资者应该如何处理市场恐慌	港股基础知识之初识港股市场	0
基金投资的收益来源是什么	基金投资者的收益来源	1
对于周期性行业的股票，你有什么建议？	钢铁行业毫无疑问是周期性的，周期结束对于大部分企业都维持不了	0
什么是HKEX	有谁可以告诉我HKEx是什么？	1
股票投资中如何进行止损	如何进行股票投资	0
正股涨可转债跌是怎么回事	正股涨可转债跌是怎么回事	1
美股清算规则	美股清算规则与RH限制交易(1)	1
为什么有些选股指标对可转债无效	可转债选股公式指标	0
什么是财富自由	财富自由	1
60岁以上的老人还可以交医疗保险吗	在上海，60岁以上老人有什么医疗保险可以买？	1
投资与储蓄之间的区别和联系是什么	股票投资和储蓄存款的区别	1
构建正确的投资体系的意义	树立正确的投资理念有什么意义？	0
为什么要买进看涨期权	为什么要买进看涨期权	1
美股怎么做空	美国股市怎么做空 美股做空期权	1
筹码峰长峰上移说明了什么	筹码峰上移说明什么	1
如何选择适合自己的股票投资方式	如何从股市中，挑选出适合自己的股票？	0
宽跨式套利的分类	宽跨式套利的分类	1
全面注册制有哪些新规	全面注册制什么意思？	0
对角线认购策略怎么操作	对角线认购策略	1
什么是期货	期货	1
上市公司为什么发行可转债	上市公司为什么要发可转债？	1
可转债剩余规模是什么意思？	可转债的剩余规模是什么意思	1
交强险过期怎么办	交强险过期怎么办	1
期货交易中超过持仓限额怎么办	期货交易中超过持仓限额怎么办?	1
通货膨胀对人们的影响	通货膨胀对人们的影响	1
储油交易怎么操作	储油交易	1
风险准备金制度的规定有哪些	风险准备金制度有什么规定？	1
中报业绩不错，暴跌的原因可能是什么	中报披露晚是不是业绩不好的原因	0
直接开港股账户投资和通过沪港通、深港通去持有港股有什么利弊	直接通过香港账户买港股，和通过A股沪港通账户购买港股，有什么区别及优缺点？	1
可转债套利溢价率为什么要选低的	可转债套利为什么那么难？	0
有哪些投资心理要不得	投资者的典型投资心理有哪些？投资者心理分析	0
什么是闭口期权	闭口期权	1
双向期权的原因分析	双向期权的原因分析	1
港股的交易方法有哪些	如何开通港股交易账户？有什么便捷的方法吗？	1
股票期权的类型	股票期权的类型	1
商品期货与股指期货的主要区别有哪些	股指期货和商品期货的区别是什么？	1
我应该如何解读经济数据以指导我的投资决策？	期货投资如何正确解读经济数据？	1
为什么要卖出看跌期权	为什么要卖出看跌期权	1
期货期权权利金的影响因素	期货期权权利金的影响因素	1
什么是百慕大期权	百慕大期权	1
期权与期货的区别	期权和期货的区别	1
美股和港股有什么区别	美股和港股有什么区别	1
买可转债怎么看溢价	怎么看可转债溢价率	1
为什么中国股市没有T+0	为什么中国股市不能实行T+0	1
美股适合散户吗	美国股市不允许散户买股吗？	0
0BV怎么用来判断股票	股市0BV线-OBV指标详解：怎么判断量价配合关系	1
你认为哪些书籍或资源对理解股市和投资有帮助？	有哪些经典或有价值的股市书籍？	0
庄家洗盘的目的有哪些	庄家洗盘的目的是什么	1
港股交易门槛	港股开户交易门槛？	1
连续4个月不中可转债为什么？	可转债为什么不中签 可转债中签率低的原因是什么	1
在选股时，我应该关注哪些财务数据？	选股时应该参考的一些指标	1
基金的投资组合中如何分配不同类型资产的比例	如何制定合理的资产配置的比例？	1
期货投机交易怎么操作	期货投机交易	1
买保险有什么好处	买保险的好处有什么？	1
可转债换手率如何判断	可转债怎么看换手率	1
公司配股是利好还是利空	公司给员工配股是利好还是利空	1
高管增持的影响因素可能有哪些	公司高管增持股票有什么影响	0
期货和股票投资的区别	期货投资和股票投资的区别是什么？	1
投资和投机的区别是什么？	投资与投机的区别	1
如何进行基金定投？	如何办理基金定投？	0
期权价值的计算公式	期权价值的计算公式	1
公司为什么提前赎回可转债	为什么企业要提前赎回可转债	1
炒可转债有什么好办法吗？	炒可转债的技巧？	1
基金分红为什么扣本金	基金分红为什么扣本金	1
抛补期权头寸怎么操作	抛补期权头寸	0
利率期货的作用	利率期货的作用有哪些	1
如何识别股票的波动率	如何看股票的波动率	1
怎样才能买入最低的可转债？	可转债最低购买数量是多少？	0
如何根据我的投资目标和风险承受能力进行选股？	投资者如何评估自己的风险承受能力	1
全员结算制度概述	实行全员结算制度的期货交易所有哪些？国内实行全员结算制度的期货交易所是哪几个？	0
可转债一定能赚钱吗	为什么说申购可转债的赚钱概率挺高的	1
基金经理的历史业绩对基金有什么影响	基金经理变动对业绩有何影响？	0
境内期货交易所有哪些	我国境内现有的期货交易所有（ ）。	1
期货风险高吗	期货风险高吗？	1
美股退市规则	美股退市规则	1
基金定投与普通申购的手续费有什么区别	基金定投与普通申购的区别	1
牛市看涨期权套利怎么操作	牛市看涨期权套利	1
投资美股需要考虑哪些长期影响因素	2020美股投资深度好文：了解美国股市基础知识及交易规则	1
为什么港股不分红？	为什么港股分红派息不除权	0
有哪些好的港股投资方法	投资港股ETF的主要方式	0
什么是限仓制度	限仓制度	1
怎么查医疗保险交了多少年	我是失地农民，每年都按时交了医疗保险。听说明年医保有变化，不知怎么文？	0
牛熊证操作技巧	牛熊证	0
怎么做成功的投资	如何做一个 成功的投资者?	1
高送转新规	沪深交易所发布高送转信息披露指引，坊间称为“高送转新规”	1
股票投资中的心理陷阱有哪些	股票投资心理分析	1
高管减持一般有哪些原因	高管减持原因	1
打新可转债和打新股有什么区别	可转债打新和打新股的区别	1
怎么刚上市就停牌	新股刚上市就停牌什么意思	1
套保和套利操作的区别在哪里	套保和套利有什么区别?	1
期货佣金商的特征	期货佣金商的特征	1
套利性交易的功能与作用	套利性交易	1
可转债的溢价率大好还是小好	可转债溢价率是高还是低好	1
基金的定投策略有哪些	基金定投有哪些值得称赞的操作策略？	1
投资心理对投资成功的影响有多大？如何控制情绪？	成功投资者心理素质	1
可转债减持对股价影响	股东减持可转债对股价影响	1
什么是基金	基金	1
如何看待分散投资的策略？	分散投资该怎么去分散	1
竞争对手分析策略从哪几方面入手	对竞争对手的分析要从哪些方面入手？	1
美股怎么出金和入金	黄金和美元和美股之间的关系	0
风险逆转的特点	风险逆转	1
如何抓美股妖股	如何判断是不是妖股？	1
什么是风险调整后的回报？	什么是风险调整后回报率(RAROC)？银行报表中如何计算？	1
医疗险的特点	医疗险观望期	0
几种常见的利率期权	几种常见的利率期权	1
基金经理的决策是否决定了基金的表现	基金经理根据什么来决定基金是否分红？和分红的数量？	0
多少资金能做期货	多少资金能做股指期货？要交哪些费?	1
美股购买技巧	怎么购买美股	0
美股交易时间为什么那么长	美股交易时间？？	0
意外险适合哪些人买	短期意外险值得买吗？有哪些推荐？	0
培养交易能力的重要性	关于交易能力的培养，量化交易能力？	0
ADR是如何发行的	adr.是什么意思	1
牛市认沽价差策略怎么操作	牛市认沽价差策略的交易过程	1
基金投资的短期交易和长期投资有什么不同	长期投资	0
可转债为什么会破发	什么情况下可转债会破发？	1
为什么说ETF基金适合散户投资	ETF基金到底是什么，为什么说是散户利器？	1
买可转债有什么指标	转债主要看什么指标	1
高管减持主要是什么原因	大族激光：公司部分高管减持主要是基于个人资金需求	1
如何快速在美股赚到钱	美股交易中，那些帮我赚到钱的免费工具和老虎证券的股票筛选器操作演示	0
主动型基金投资建议	主动型基金投资的都是A股吗	0
港股如何看行情	港股现价成本和行情怎么看	1
港股通参考汇率包括哪些	什么是港股通参考汇率？	1
如何进行基金组合投资	什么是基金的组合投资	1
跨期买卖的作用	跨期买卖的作用	1
基本面的选股方法有哪些	基本面指标怎样选股?基本面选股方法	1
偏股型基金和偏债型基金的区别	偏股型基金和偏债型基金的区别	1
筹码高度集中有什么特点	筹码高度集中是什么	1
牛市套利怎么操作	什么是牛市套利?如何操作	1
主力净流入的计算公式	竞价主力净流入公式	1
一般单位客户与特殊单位客户的区别	特殊单位客户与一般单位客户的区别 金融期货市场上两种机构投资者的区别	1
停牌和退市有什么区别	停牌和退市有何区别？	1
超大单和大单的定义	超大单和大单区别	1
可转债值得玩吗？	为什么不建议玩可转债？	1
内盘与外盘是什么关系	股票的内盘与外盘关系	1
公司回购股票对散户有好处吗？	上市公司回购股票对散户是利好吗,股价会涨吗	1
如何根据市场状况调整我的资产配置？	当下市场资产应该如何配置，珍惜当下市场的位置！	0
可转债强赎回有什么后果	可转债强赎回什么意思	1
基金公司的规模大小是否关乎基金表现	基金公司的资产管理规模的大小意味着什么？	1
基金累计收益率低于指数水平有什么影响	很多基金的累计收益率走势在短期内低于上证指数和沪深指数,长期的时候高于他们	0
如何避免常见的投资错误和陷阱	投资者在交易中如何避免下单错误的风险	0
窝轮与牛熊证的比较	窝轮、牛熊证是什么？窝轮、牛熊证是正股的衍生品（实际买卖方法	1
可转债三低指哪三低	可转债三低清单（20190923）	1
如何进行美股投资	美股下跌怎么投资	0
基金可以追涨杀跌吗	基金可以追涨杀跌吗	1
为什么有人总是在股票市场中亏损	为什么中国股市的股民总是不断亏损？	1
主力抢筹是什么意思	主力抢筹	1
为什么决策时要考虑投资组合的多样性和风险分散	证券组合与风险分散有什么关系	1
期货交易所的职能	期货交易所的主要职能是什么	1
可转债转股价低于正股价 是不是我转投后就赚钱了	转股价低于正股价是不是赚了	1
大宗交易制度的意义	大宗交易制度	1
如何进行基金赎回	基金如何赎回	1
为什么基金的管理费不一样	为什么基金的管理费不一样	1
美股主要看什么指数	美股一般看哪个指数	1
私募基金的五大误区是什么	私募基金有哪五大误区？ 私募基金有哪五大误区？	1
金融期权的种类	金融期权的种类	1
美股交易规则是什么啊	美股的交易规则是什么	1
给大学生的理财建议	大学生理财的观念,说明下原因,并有何感想和建议	0
商品期权概述	商品期权概述	1
死亡谷形态的特点	股市中的死亡谷形态是什么	1
可转债双低轮动策略	双低可转债轮动策略	1
a股港股美股的区别是什么	a股港股美股有什么区别	1
为什么说可转债越低越好	可转债为什么溢价率越低越好	0
出现红三兵形态好不好	红三兵几种形态	1
牛市看涨期权套利的应用策略	牛市看涨期权套利的应用策略	1
为什么融资融券会强制平仓呢	融资融券什么情况下会被强制平仓	1
什么是恒生综合指数	恒生综合指数	1
什么是股权类期权	股权类期权通常包括什么	1
基金赚钱基民却亏钱的原因	基金赚钱基民不赚钱的原因找到了	1
期货保证金存管银行有哪些	期货保证金存管银行	0
女性如何理财	女性如何实现财务自由 成功理财必不可少	1
如何避免常见的投资错误和心理偏见	从机构投资者的专业角度来看，普通投资者都有哪些常见的心理和经典错误操作？	1
为什么银行理财也会亏损	银行理财产品会出现亏损本金的情况吗？	0
选股方法有哪些	选股方法	1
智能定投和普通定投的区别是什么	智能定投和普通定投的区别？	1
如何判断公司的行业发展空间	股民们如何判断行业发展空间	1
如何分析财务三大报	财务报表分析3_[全文]三,[],全文,会计分析,财务报表,财务分析,3报表	0
投资美股需要注意哪些法律和税务规定	德璞资本：国内投资者投资美股的时候需要注意哪些问题？	0
马鞍式策略的风险收益	马鞍式策略的风险收益	1
美股出金麻烦吗	美股出金攻略	1
公司股价已经出发可转债下修条件了，为什么还不公布是否下修？	什么是可转债下修	1
基金种类怎么区分的	基金种类怎么区分的	1
市价指令的优点与缺点	市价指令的优点与缺点	1
如何应对市场波动和风险	防范市场异常波动和外部冲击风险	0
在市场波动时，如何有效控制我的仓位？	市场下跌时，指数基金定投比例和仓位的控制方法	0
涨速的计算公式	计算股票账户涨速的公式?	1
指数期货的影响因素	美元指数期货	0
基金的净值和市值是什么意思	基金净值和市值是什么概念？	1
期货介绍经纪商的作用	期货经纪商的职能	1
何时买入和卖出基金	基金何时买入何时卖出	1
什么是纳斯达克交易所	纳斯达克交易所	1
怎么选择合适的保险产品	如何选择合适自己家庭的保险？	1
如何研究和理解市场的宏观趋势？	中国经济理论对市场的理解	0
会员分级结算制度概述	会员分级结算制度	1
普通人能买原油或股指期货吗	普通人如何炒期货	1
定投的时间段和间隔如何选择	基金定投怎么选择时间间隔？	1
股市有什么风险	股市的波动属于什么性质的风险	1
新发行的可转债怎么买	可转债怎么买？	1
影响窝轮价格的市场因素	影响窝轮价格的主要因素有几个，第一，是相关资产的价格，这个相信大家会比较容易明白。以CALL轮为例，一只价内轮，当相关资产的价格升得越高，资产价格和行使价的差距就越大，内在值就也会提升，从而利好轮价。即使是价外窝轮，如果相关资产的价格越高，就算还未到价，升穿行使价的机会也会增加，因此轮价理论上也会受惠。	1
医疗补助金怎么申请	医疗补助金是什么意思？补助金一个月多少钱？	1
熊市看涨期权套利怎么操作	熊市看涨期权套利	1
农村医疗保险有什么用	农村医疗保险	1
趋势交易战法效果怎么样	GAEA：终极战法——双均线策略	1
引发股灾的原因	引发股灾的原因	1
可转债上市交易最高限幅是多少？	可转债上市首日交易规则？	1
道指、纳指、标普500三大指数怎么选	美股三大指数选哪个：道指/纳指/标普500	1
期货弃仓的原因有哪些	期货弃仓的原因	1
持仓限额及大户报告制度的作用	什么是持仓限额及大户报告制度？	1
可转债的涨幅和正股有什么关系	可转债和正股的涨跌关系？	1
金融期货和商品期货的区别	金融期货与商品期货的区别	1
倒挂老鸭头形态与杯柄形态的区别	倒挂老鸭头	0
股票投资中如何进行风险分散	论述股票投资的风险表现以及风险分散机制	0
如何进行事件驱动投资	事件驱动型投资	1
跨期买卖的基本方法	跨期买卖的基本方法	1
可转债停牌会有公告吗	海富通上证投资级可转债及可交换债券交易型开放式指数证券投资基金临时停牌公告	1
窝轮交易规则	什么叫窝轮牛熊	1
集合竞价抓涨停战法是什么	集合竞价抓涨停具体操作方法	1
怎么给60岁的老人买保险	60岁老人可以买什么商业养老保险	1
累计净值小于单位净值的原因	为什么这个的累计净值小于单位净值	1
可转债是中风险还是低风险	可转债是低风险还是中风险？	1
港股为什么不可以直接买	港股可以直接买吗	1
请问融资融券和股票配资有什么区别	股票配资和融资融券有什么区别呢？	1
通过什么看主力是否洗盘	什么是主力洗盘，怎么判断主力洗盘呢？	1
时间价值投资策略是什么意思	价值投资策略	1
股票增发复牌有涨幅限制吗	涨停股的下跌阴线买入绝招	0
美联储加息如何调整仓位布局	美联储加息	0
